??-T-BBBM--MBBBBM--BBBBBBBBBB??BBBBM?BB--T---B----------------BBBBBBBBBBMMM-----------EMBBBBBBBB---BBBB?BBB?BBBB-B--BBBBMMB???TMMMMM-BB?MBBBBBEMBBMBBB-BBBB??------------M----------????????M-BBBBBMMMB?
-MM|----M-----------------------------B--|----X--X------MMBT--MM-----T--------M-BB-MM-M--B--BB-|------???X-------BBBBBBXBB-----------------B--B--M?TMM?-M-MMM-MMBMMB?B---------?X?B-----B-BBBX----------
--X------BB--??-??-X-X-XB---TBB--M-----E-B-M-MX--X-MTBBBBBB-?--B---E---?????????????-XM?M|MME--B---------X?B--?B-???M??X???BBBBBBBTBBBBM?B?-T---X-B---?--BB-XXB-BT------BBBBBBBMXB-B-B-------XB---B---BB
X-X--------T----?????X?XBXBBBBB----?--BBMMM?MBBMMXBMMBBBB--?|-??---M-|--?-???--B---B-XM?MMMM???-MM-----X-X-------M-----?---?--BBB---?B--MMBMB-BB-BB|-M-EX-BBXXBBBXBBBBB??-M----BX---B------BBXBBBBBB|BB-
X--|---T|-B-T---B-XX-XBBBBB-?-E-B?---X------BMMMBX--|---------X---MM?|MMM???|????-?--X-?M-----X----------T--X---?---?X--?-X--|?M--|MM---XM--|----BBB?B------XX---X--M--MX--M-B-MX|---??????M?XM??????--B
T|MBB??MMMM|----M-?-EX-X---MMTMMMMTBBBM?M|??-X-?BBBB|?-X----X-X----M-|T----MM-MBM----X-BBBBB?????|???--X-----------??----?X--T---------B----|-|-X-------B|B?XX???XE????-X----B-BX?B??X??B?T-BXBBBBBB|MB-
X------|--BBX-BBM|X-?X-XBX?--X-----X---MBX-MT----XMBB--XX-BB|-EBB-B--|---?--MT----BBBXBBB-----XT------X--XBB---?-----?-X-----------?????-----?|-X---?BBB?|-MXX?M?X?MMMMMXMMMMMMMXMMMMMMMMMMM-X-------|-B
X|-----|----X-X--|---X--|TMBBX-XB-|----B-X???T--?BTB?|XXX|BXXBXBX|-BXBB|-MMMMXXM|---BX--BB-M-B--?E---??--X??????????---X--X--B---X|-MBBX----|MM-XM---BB--|XBXXBB-X-BB-BXX-E|?-|-XBBXBBBBBM|BMX---X-?|BBv
X|MMMMMM-BBBBBBB-|E|XX?X|M?M-|TBMM|X---BBXB-|----X---|-XX|--X-XM---MX--?-----XX--??X-X???-?--????XX-B--BBX----M---MMBTBXMMMMM----XM----X???-|------|----X|BXXXBB-X--X--XX-?--?BEX??X??????BB|X?--M--|X-f
XX----BTB--BX--B-|X-?X-X||---X-BBBB-MB-MMM-|-BE-BX|-XBXXX|-B--XB-|--XMM---X--EX??M?M?X???-|-M-XMBXX------M?MMMMMMXBBBXBX-B?BBXBB--|-X--X---XX-X--X--BBBB-|BBXXBBBXMMXM?XXM-|--MXXM---X---M|-|X-X-------f
X-E-------X----B--BB|XBX?B?BTXBXB-??-X---X--|MMM--|-M-?XX|--X-X-??--X-?-|-X--XX?|???-X--MM-M--XM--X????X-X-?T?--?X-E-XMX|M???XEBEXB?TBBXB?-XX---------B|-|X-XX|TM-?-??XXM-X----TXX---------X|X-X|---|-Xf
XXX-X--|----XBXX??XX|X??|--BBXBBXBMMMXMMM|MM|MMMMX|----XX||-|-?-X---T---|-X---X--X---X-XMM|MMMMMMXX????X????BBBBBXBBBXTXMMBBBBM|?X-?-?BX??XX??B?BBX?B|-X?|X-XXTBB----MXX--TBB--XX--------X|X|X-XB---??-f
X---X|-|---T-X-B-?BXXX--B?BE|X------?X-X---||-?--X|-X--XXB|-T-|-----X---TEX---X-|X---X----XB|BXBBBXBBBXXBXBBXBBXBX-|-X-X|-X------X--M--X-XXXX-T-EX-X-|---|X-XXMMMMMM--XX-MX----XX-----B-?T|X|X-X--X---Xf
X|X--BB|--?XBB------|X--BB-B-X-----X-X------?-|???|???-XX|?-X-X--X--X-XM|MM--XX--X-MMXBXMM|MMMXM?XXB|BBBBXMBMMBMXXM--MX|MMM--XM--XM-X??X??XX???|XX?|??BXBXXMMX|BB-M-X-XX--|----XX----?T?-X-X|X?---X----f
X-X-BBB|BMMMXE-T--X--X-XE--||XX-XX---X--M-M|--|-MXM----XX||TX-XBBXBBXBX-|-X--XXX?XMXBXMMMM|MM-X|-MX????|??|T????EX-|--XX----?X--?X|-TMMX?-XX-E--XX-XTM?X--X-XX?TTXXM??XX--X-?--XX---?X---XBX|X-XE-|X---X
XXXTXXXXXXXXXXXXXXXXXXXXXXXXXXXXXXXXXXXXXTXXXXXXXXXXXXXXXXXXXXXXXXXXXXXXXXXXXXXXXXXXXXXXXTXXXXXXXXXXXXXXXXXXXXXXXXXXXXXXXXXXXXXXXXXXXXXXXXXXXXXXXXXXXXXXX-XXXXXXXXXXXXXXXXXXXXXXXXXXXXXXXXXXXXXXXXXXXXXX
