??---MM--M-M-B---------BBBBB-?---B---T---TB--T---B--------?--BB---------BM--MB-?--M-MB-BM-MMM-M--MB----B-B-BB-BBBBBMBBBBBBBBBMMMMMMMMMM-----?---B--MBBB---------??---?---------------?-????-MMBT?--?????
--M--BM-B-??B-?|??-?BB------BBTM-B-MM?B-|--B-T-B---B--|BT--?-MM??MM???M?M--MM?X|M-M?X??T??---B???---?------??--?-??--?B-?----B---M---M--B-B--B-|-X?M--?B-XX-M-MBBM-?---BB----T?X??-?-??-?-B--?BB-?BB?B?M
---------BBB-?-?-??-?M-MB---M---M------|-E---|---X--------?M????---------|----X?---?X--?---BB--B--E--MM-XBBXTB?BB?BB--??-??-BXBBBBMBB?????MMTBTB-B--B----XX--BB?BT-B---XBB---BBMMBMXMMMBMBMBBBB--B-M----
--|---B-----------T--?--EX-----------|BBBB-M-BB-|-----MB--|M|-?--E-?B----|-B--M-----XB----BM-BB-MMMMMM--XX-MBEXE--X?---?BBBBBXB--BB-BM?????M--X??B-|B-MEXX--B--B---BTBMX-M?B?B??T?MXBM-BB-BX------M-|?-M
--E|---XM---|?B--MX---BBM-BMB-|--?X?BX--X|-----M-----B-?M--X--X--??-MM-?--?|--X-----?|MM?--BMM?BXBBBBBXMXT|X-?|-?-X-M-M-EXMMMX?BB||MBB-MBMBM|?BBX--B-X---X----|-BE----XX--?-BX-B-B---------X------B---X-
?XMBX----?XM?---X--X--?BB--XMX-M--M-X-M?-|-----X-BB-B?BBBM--X-XM--B|---M-X-M--XBMM-?XBBM-?---M--?|------X--|-------?-M-M-?-M-XMM-|-----B---T----BX---X-|BX-X-XT----|---XX-XX-B-MB--X?X?B-B-XB-BBXB??XM??
BX---BX-BX----XBX|XX--?-MXX--?-----B----------X--BMMB--X---XMMXB-B-X--?E-M??BMX?B-BB---BB-BT-------B-MXMX-|M-M|?BBXBXXBMM--EXXX--|X----X-M--BX-||X|-?X?M?XMMB??--XMB|-|XB-XM---B-B-XT|X---XXM---XX???T??
-XX---EM-----|MM-|X--X--E-BB-BBB?--------?????XXXXBXB--XB-|X|EX--|-XX?BM?X?E-?X-?-|-X|?X--?MM-?BMX|-B----BBX??XBB?E?X?||--X--XX-B?XX?-B--??X|T---M-X-X---XX--XE-?-B||?MXX-X|?----|BXB-X---BXB---?---?BBv
-X--M-MM--MT-B-E-|B-BXBX?-B---TB|-BX--TB-|B-|XX-?X---|X|----E-XXMM?B|B|BBBBBBMMMMMMTM|TXMMM|-X?--X|MBM-XEX-X--XX-XXM-XM|-MMBMXX-MXXMX--XX-XB---|-BBBBBXBBB|BMXB-B--BBXXXBBXBX?BXB?BXBX?-?-X?MB-X?-M-X-Mf
|MXM---X--X-?X?XM?XMMXM-XM?-BX--MMBB-B|E-B--B-ETBX??-MXX---XXMX?-T-E-MME-----?MM?MX?XBB?MBBX?B?-XX?--?-?XB||-X-?-B-X--BX-X---XX-B-XXXBMB-MBXB|||?X??|BX--XBX?XB-B-X-|MXXXMX----|||XB-BB--BX|BBXXX-----?f
|XE--BB-TBXB-BBBX?-?EXXXBM?X-?X??-??BX?BBX-XXXBB|B--????X--XXXX-?M-?M--BBBM|MB-|--?MM?-X??--X?XB?X-XTB??X--M-|--B-XX-|X---?XBXEXTXX---BXX?-X-XMXBEMM||M?MM-MBM|--MXM?X-XX-XBXB-?|--X-X?X--XX--X-|---X-Xf
|BX-|----?MB-BX???BMXX?XM-XXXX--M---XM-B-M-|XX-B--B--?X-X-BBB-X--?-X|-------BTX?X-XB-X-X--M---M|-X-?-X-X?B-X-XX---XXXB-BBMBBXXX|?XXX|MMBX?X---B?MX-?||MX?|XBX|B-?-X--XXXX--X--XB---M-X----||-XMX----?X-f
|BXBXB-|--X---X--??-XX-|BXBXB-X--X?---M-M-?MXX?B-X----X-X-MXX?X??--XX----XM--?X?|-X--B-XTB-BXBX--X-------B|-E--X--BXXB-X-|XB?|X-X-XXMB-|XX-X--|BE----?---XX--X--?X--X-XXXMX-X---T-X?-|BBXMBXBMMMTB|BXBXf
|X|-???|?-??-B?X-BX?XXX|?BXXBX-BXX-X-X-X--?XBXB????M-XX?X-|BBBX--|----BB-----XX|-X-MM-X--||B-BX--|--|--XMMMMXTXMM?XMXX?EBMM?X?XMMXXMX-MMX-XXX-?X|X?X|-----XXXX----MXXE-XXX|--|X-X|X-X?M|---X---X-??--B-f
|?X?X-X?X?X?-E-XXXX--X?X?X--XXXBBX-BXT--M-M-XXX-MXX-?X-XXX?-X?X-|-BXB-??--XX?MXM?XXXBXXTBM??X--|X--X---|-||B-|X?B|?MXXXX|X-X?XXMX-X-XX-X|---XE?X|X?T|XX|-?X--X?XBB-MXXX-XXX---TXXXXX?X?EMMB|X?--|MTB-XMX
XXXXXXXXXXXXXXXXXXXXXXXXXXXXXXXXXXXXXTXXXXXXXXXXXXXXXXXXXXXXXXXXXXXXXXXXXXXXXXXXXXXXXXXXXTXXXXXXXXXXXXXXXXXXXXXXXXXXXXXXXXX-XXXXXXXXXXXXXXXXXXXXXXXXXXXXXMXXXXXXXXXXXXXXXXXXXXXXXXXXXXXXXXXXXXXXXXXXXXXX
