T?-E-----BBB----MT----T----M??M?????M????????????-----MM-M------------------M---BBBBB------B-BMTMB?BBMMB-B--B---B-B-B-BMBB-B--?-------MM??M????BB?-MB-M--M----------MBMMMMMMMMM--?-----------?-T?------M
|-TB----BBMBB?BBB|BBBBBB-M---B-BBBBB---B-BB-------MM-?-BBB???XBBBX----E----?-?---???-----------||-MMM?M--------M--------M-??--B-----B---B---------?B?-M-M?BBM|-B---E--BBM----TM--M??-M|---B-MM-T-B?B????
?MMMXMMB-----B?-?|-B?--EM--MX-------MMMMMMMMM-TBBBX??BB-??---M-MMX---MM-MX--------------------M|MMBMM-B--BB-B----------X-----?M-M-??T-|--?---X----|--T-----?--B-BTBB-BB-BB-B---B-B---??-------M--BBB-B-E
M--BX??M???M-T-M?|---E?M?-|------M--X|BB|M-----?M--B--?---X------X-X-X--M|?X----M---B---B?--T-----?--X-M-----MB?-XB???-??---B-BEBB-|-MMMMMTMMXX?----BB??MBBMB|BBBX----XE-MXM--MM---MMB|B|BBBBXB|B---|B-o
|---X--X--X---EETM--???-|-BB?BBBMMMMXMM?X-M---M---X??--MM?X--X---X-X-XM----|--X--MMMM--M--MXX?XM--X----M--|-X-|--?-M?B?-???-??BXB-B-|--|-BBBBBXBXBMBBMBM--MBMBMMBE-X---X?|T??-?----?--|M--M--X-|M-XM|-X?
|--BXBBB?BXB????-?---?E?B---B-BMBM|?X?|????T???X|-X--|-----------XBXBBBBBXBXBMXBBBTBBBBBB?BB?????X--XX-----|---MM-X-X-|MMMMMMXMM?B??|M??-?|???X?X?E?-------?---?BX-MM-XX-|XB--M-B?BX--MMMM-X--M|-XX-XXXE
X---X-----B--XB-M-X--?B---X-?-----??XE--XB-B-X--|BX--BBBB????EXBBXBXM-??-X??--X??-X------T-M-XBXBBBBB?BB-?E-X--XT-X-X-BBMXXB?XB???B??-??-X|BBBXBXBX?--|-B?XBB?----BB---X||XXM-M-MMM--|-T|MMXM-BMM?XBB-T|
X-X-X---|??--X??-XX-X---BBXBB?XEM-X-XM--B-?|---XMXB-XT-MMM|BBMX?-X-X|-B-BX?|--X-XM|M--XX-T----|BM--B--M---XBB--XBXXX|M|MX-BMMXXMXMB???M|??MXM-XM|??X??|M-XX|T|--?X?|MBMX-MX-M|E-T--?-|--|X?X-M|---XBXBBv
BM--X-X-X--|BX-BMX-MXMMMM-X---X|----XT--M-MBBM|XBXBXBBB?MMMM?MXMMXMX|-|MX-?XMMXMTMBMBMTMTX-|-T-XBXB-MM--B-XMM|-X|-XX|---BTX-BXXMTX?X????MX-XX-XM-MMBMM|ME-XMXBM?BX????XX?XXBT-BX--?-X--|?-|X--M--XX-XX|?
M---XBB-??X|BX?B?X?-X--BBMBBXBX|-BMM-B|-B---B-X?BX?EX|BXMXB?XBM??XMXM-XBB--BM-X-X?-???MXX|M?BXX??X---B-B--X?--|X?-XX|X|--XBBBXX-X------|-T-X--X-M-XX--?-?-XX---?XX---M-X-|X-|XBX-BB--|BBBTTXBB---MX|---?
X---XM|-??XE?X?M?X|---X----|X?X|M--B||---????---|B-BX|X-MXX-|XMB-X-BM???X??|B?X||-???????|?X??X|BX??M?B??|?-M--XX-X-|--MMM---XX-X?-X-M----XX--XXM|XXBXM|--XXM-M--X?X??XX??X-X--X----?|-|??????|?|BXBXX|M
M-XXXX---BXXXX-T-XT-?-XX-M-XT|X|-?XM||X??|??|-XB-?--X|-XMMXMMT?------BBBBXBB|BXB??BXB|B?????XTBT?XBBBXXXM?XMXM|X||X-|-|-MM---XX------X--|||XX-XXEBXX|XM-B-X--M--?MX?--XX-?-X|-BB?-----BBXB?BM-X---XXX-?-
T--XX-X-?-XXBX-?-XT?X-XX-?-XX-XX??X-||X----|B--X--T--|----|X-B----|X-B--BBXTXBX|X----B-XBM-T-TXBBXBB---?B-?-|X-XM-X-|X-X-|-B?----X|BXM-M|M|XXMBBXXXX-X-|--X----X---MBB-XX-XBBXX-|----|--|B-XX---TXX-XXBE
oXX|XBX???XX?X?X?X|MMMXM-BX---X-BBX-||----M||XXX-X--X|XTX?-X-|???----BBXBBB-TXXMX?M??X|MM---||||TX-|-------X-|-X-BXMX-B-X?B--?X|-E-MXT-|XT-XX-X--XXX|X?|-?X--X--XXXXBEXXXBBBBB--|X-|XB--X-MMX--|M-X-XEXE
|X|?X??T?|?X?X??MX|XT-XT?-TXXXXXBB-BXX--XBMB|X?X-XMXX|TMXXMM|XMXBX|BBB|T?XX|XTX-X-XXXXMM?MT|?X?X|BX??-X---XBTX?XX-X--?---XBE?XX-------X-|X--X-E--X-B|E-MXXXMMTMXXXXX?MXXB-M|M??XE-BXXM?TMM?XXXXB?-E?TX||
XXXXXXXXXXXXXXXXXTXXXXXXXXXXXXXXXXXXXXXXXXXXXXXXXXXXXXXXXXXXXXXXXXXXXXXXXXXXXXXXXXXXXXXXXXXXXXXXXXXXXXXXXXXXXXXXX-XXXXXMXXXXXXXXMXXXXXXXXXXXXXXXXXXXXXXXXXXXXXXXXXXXXXXXX-XXXXXXXXXXXXXXXXXXXXXTXXXXXXXX
