-------------M-MM----------------------BB-----B---------BBB---------------B----------------------------------------------------------?-????-------------?-?-?------------?------?--------------BB--BMM-M
--------------------------------------------------------------MMM--MM------------B---B-----------------------------MMM---M-------------------------------M----------------M-----------------------------
----------------------------------------------------------------------------?----------------?------?--E------B--------------M------------M---------------------------------------------?--?------------
--------------?B-?-----------------------------------B-------------------------------------B-----------MM---MMM-----------------------------B--B-------------------------M------------------BBBMMB------
-------------------------------?----?--?------------------B-B-BBB--------------------?--------------------------|-----------------?----?B-B--MM---------??-?--------------------------------------------
-----------------------------------------------MMMMMM?MMMMMM--MMM---M-----B--B-B-------------M-----------B------|---BB-?-B---?----------BBB------------?-?-?--?----M-----M----B--BBB----B---------BB----
--------B--------------??-?-------BB-M---B------------------------------------------MM----MMM---MM--------------|-----?--------B---BB-------B----------------------?-----M------------------------------
------------------------??-------------BB-----B-B--B-------------------------------|-?---------?-??-------------|-?--------------M---------------------------------?---E-------------------------------v
--------------B?----------B----------B--B----------------|------BBBBB-BB--B--------|-------------------------M--|----------------------------------------------?M------B-----------------------------|-f
--BB-BBB-BB??-?MM-??--?--------------M-MM----------------|M----------------B-------|----------BB-BB---E---------||-------------M---------------------------------MM---MMM----------------------------|-f
--------?--?-----------------------------------------?---|---------------B----B----|----------------|-MMM-------||BBBBBBBBBBB--M--------?-?-------------?-?--------B-------------------?-------E-----|-f
------B---------------------M----------------------------|-----|----------------MMMM---MM-----------|----|M--B--||-----------------BBBBB-------------M---------BB--------------E-----------B---BB----|-f
-------------------------------M------?------M-----------|M----|---------?------M---B-BMBB---B?B?BB-|----|---MM-||------B-B---------------?-------------------?BB?-----|M--M---?--------M--?---------B-f
-----------------?--M--?------M---------------M-M--------|-----|-----------------?------------------|----|------||------?-?M?---??--------------------------------B----|-------------------------------f
m-----X---------X-E-------X-X--------------E-----------EX|-----|-T------------B-?B?X-B--E-------X-E-|----|-----E||-???-T-----E-----X--T-----EE-----X-E-T-----BT-------E|-----------------X-----------??X
XXXXXXXXXXXXXXXXXXXXXXXXXXXXXXXXXXXXXXX-XXXXXXXXXXXXXXXXXXXXXXXXXXXXXXXXXXXXXXXXXXXXXXXXXXXXXXXXXXXXXXXXXXXXXXXXXXXXXXXXXXXXXXXXXXXXXXXXXXXXXXXXXXXXXXXXXXXXXXXXXXXXXXXXXXXXXXXXXXXXXXXXXXXXXXXXXXXXXXXX
