------BB----BB---------------------------------------BM----B----------------------------------------------------------------------------------------------------------------B-BBB-----------------------
---BB--------------------------------------------------------------------------------------------------------------------------------------------------------------------------------B-?--MB--M---------
------?B-------------B-------B-----------------------------------------------------------------------------------B----------------------?---------------------------------------------------------------
------------------------------------B-B-B--------B-------------------------------------B---------------?-------------------------------------------B----------------------------------------------------
------------------------------------------------------------------------------------------------------------------------B---B-----------------------------------------------------BB---------B-B?--BBBB-
----------------------B-BB-----B-B----------------------------------B--B-BBB-----------------B?--------B---------------------------------------------------------B---B---------------M----B---B---------
----------------------------------------------B------?B------------------BB?-------B--------------------------------------------------------------------------------------------------------------------
-------------------------------B----------------------------------------------B---------------------------------T-------B----------------------------B-------------------------------------------------v
--------------------------------B----B---------------T----B--B-BB----B--B---------------------B-----------------T---------------------------------------------------?--B---B-B-------------------------f
--------------------------------------?--------------T------B--B---------------------------------------B-B------|--------------------------------?-------M-B-------------------------------------------f
---------------------------B-?--B-B--?------M--------T-------------------------------------------------?-B------B--------------------------------------------------------------------------------------f
--B--B--B-B------------------------------------------|-------------------------?----------------------------------------------M---------------------------------------B--?B---B?-----------------------f
--------------------------------------------B-BBB---BBB-B-----B--B-?-----------------------------------------------------------------------------B--------------------------------------------------T--f
---------------------B------------------------------------------------------------------------------------------------------?-BBB-B-----------------------------------------------------------------T--f
m-----X-------E----------B---------B--------------------------------------BB--------------------------------------------------------------------------------------------------------B----B----------|--X
XXXXXXXXXXXXEXXXXXXXXXXXXXXXXXXXXXXXXXXXXXXXXXXXXXXXXXXXXXXXXXXXXXXXXXX?MB?BBBBBXXXXXXXXXXXXXXXXXXXXXXXXXXXXXXXXXXXXXXXXXXXXXXXBXXBXXXXXXXXXXXXXXXXXXXXXXXXXXXXXXXXXXXXXXXXXXXXXXXXXXXXXXXXXXXXXXXXXXXXX
