-----------------------------------------------------------------------------O--------O---------------------------O-----O--O-------------E-----------------------------B-------------B---?B--M------B---
----------------O--------------B-----?------O--------------------------------BBBB-----B--?----------------------------O----O---------B-------------------------------------------------E------O---------
--------------O-BO--B----------------------------------------------------O-------------------------------------------BB-B--?B----------B-B-B-O-------E----------------------------------------B----B-B--
--------------O-------O--------------------------------O-O--------------------O-------------------?---B------O----B-----------------BB-?-B---------------------------------------------O------B---------
-----B?--O---??---?-O------------O---?B-----B------------O---------------------BBBBB---------------------------------?B-B----------BBBB?M?BB-------------O-----------------------B-----??-----O---------
------O?-B--M---B?--B-?--------O-------------------O--B----------------?-?---BB--------------------------B---B----------------------------O--B-BB--O-B??-B---B-------------O----E-------------E---------
---------------------------------B---M------??-?B------BBB------E-----------------------------B---B-------------------------------B?--B-B-----?-----------------------E----OO-OO----OE--------B---------
-------MBB---------------------O------------------------------------E-----------------------------O------B-----------------E-----MB-------?-?---?---------------------O--B--B--B----BB-----------------v
--B-BBB-B----------------------B-------------------?------------------------------------------B---B--BM-----------------------O-----O------------BBM-------------O---------B--?-B----------------------f
-------O---------------------B-B---O--------M-------------------B---B----?---?--B-----O---------------E---------------O-------------O---O------O-------O--------O-----T---O---------------------------Bf
-------B---------------------BB?-B-------------------------------------B--------------------OTB---B---?-------------B--O---B--B-----B----------------??B-B-----O-B----|---E-----------?----BB-------T--f
-------------------------------------B------?-----------------T-----------O-----------E------|-------O-------O---------------------------------B--------B----OBT------|---B-------------O-----------|--f
---OO----OOO-----O------OO---------?-----O--O--OO---EO--------|E-E-?-O----?E-O---OO--OTO?--O-|O---?-O-OB--O--OEO----O-?-------?E-OM?--BOBE-?-O--OOO-E-OT--OOO--|BBE---|O---OOO---E---------OO-E-?-OO|-Ef
---?--BOO---OBB---O------O--O--------O----O-O---------OOOO--O-|O-O-O----O--OO---OO----|--OBBB|-OO-OETO--E-OEEMB-O----?O?O--OOOE---OO-O-O--O------E---EO|---OO--|-O----|---OE----O-----------OE--OO--|--f
m-O----O-----O-O-----OOX--O-OO-------X---O--------O--O----O-T-|--O?O---O-O-OO-OT---O-O|OE-XE-|-O-EO-|T--------O-O----TXO-----E-O---X--OE--TEO-EE-OOO-O-|E-T--T-|OOOT--|O-OX-OO-----OE-TOT--------OEO|--X
XXXXXXXXXXXXXXXXXXXXXXXXXXXXXXXXXXXXXXXXXXXXXXXXXXXXXXXXXXXXXXXXXXXXXXXXXXXXXXXXXXXXXXXXXXX-XXXXXXXXXXXXXXXXXXXXXXBXXXXXXXXXXXXXXXXXXXXXXXXXXXXXXXXXXXXXXXXXXXXXXXXXXXXXXXXXXXXXXXBXXXXXXXXXXXXXXXXXXXXX
