--B??BB?MB?B?----------------------M--------------------------------------------------?---?---------------B--------?---------B-------------------------------------------B-BB---B-----------------------
--------------------------------------------------------------------------------------------B-B-B---------------------------------------------------B----M?B--------------------------------------------
-------------------?--------B?BB?B-BBEB--------------------------BB---------B-BB-?-----------?-------B-------B---?--------------------B?B---B-B-B--------------E-B-----B-B-----B------------------------
----------------B-----------------BM-B----------------------------------------------------------------------------------------------?------------------------BBB-----------BB---B-----------------------
------------------M--BE---------------------?--??BBB------B-B--B--?-B-------------------------------------------MB?BBMBBBBBBB?B--------------?B----------?-------B-----------------------?----------B--B
--------------M----B--B?---------?----?M---B--?-----------------------|--------B-BB-B------B-B--------B--?-B-----B--B-M-MB-?----------------------------?----B?B----?-B---------------------------------
B--?--?--M-----------?----------------------------B---B-B?------------|-----------------------?-----------------BB----------------?-B---BB-B-----B-BB-B?-------------EB-------------------M-B-B-B-------
------?--------------B-----B-?--------------B--B---B-?-B--------------|------B---------------------------------------?B------------------------------B-?---BB---B--?BB----------B----------------------v
---------------------------M---------------M----B---------?-B--?--B?M-|-----B-B--------B-----------------------B--B---B-MB--B------------------B-----------BBB---------------------------------M-------f
B??BBB?--B-?B?---------------------------------B----------------------|------------BM---------B---?-----------------B---------------M----------------?-?B-M------------------BBB--B--------------------f
----B--?-?-?---BB-B-BB-----B-B--B--B-----------B--B---B---------------|---BB?B-------------------------------------------------------------------B-B--B----------------B-B-------------|---------------f
--------------------------------B-------------------?------?-------B--B-?-?B-B-----------------------B----B-B?--?---?---M-----?--------------------------------------B-B-B-BB---??--E--|--?-B-BBBBB----f
--E------------?--------------M-------------------------------------------------------M-------M----------------------------------?B-?----B-----------?-?----M-M--------------------M?--|------------B?-f
-BBB?M-MB-------------------------B------BB-?B---------------------------------------B?----------------------------?---T--------------------??BBBB??BB---------------------------------|---------------f
m-----------?--B-----BX----M------T----X--------T---B-ET------BT---XX--------------------------B-E--------X-BTBX----T--XX--B--X-B------------?---------------XX--------T--------?BBMBMM|BBBBB---|----E-X
XXXXXXXXXXXXXXXXXXXXXXXXXXXXXXXXXXXXXXXXXXXXXXXXX?XXXXXXXXXXXXXXXXXXXXXXXXXXXXXXXXXXXXXXXXXXXXXXXXXXXXXXXXXXXXXXXXXXXXXXXXXXXXXXXXXXXXXXXXXXXXXXXXXXXXXXXXXXXXXXXXXXXXXXXXXXXXXXXXXXXXXXXXXXX-XXXXXXXXXX
