--BBBBBBBMB?B?B?B----------B----------------------B-------------------BB--B-BB-B-----------B-----BB-?B?-------B-B----BB-------B-----B-------B?B?BB--B-?----?------B----BB-B-----B-------B--------B---B--
------------?-BB?BB-?--B-?------|----|---?--?-B--?M---?BBBB-B-----------?-----B------------B?B?BBMMBBBBB?B-------B-----------B----------------B------------------------EBB-----B---BBBB-BB--BB--B----B--
B-?-?--BB-BB-B--B-?-BB---B--?--B|BMMBB-BM----------BB--B---BB-MB------------------B---B---|----M?--B?MB-B-----------BB----BMBB-BB--B-?---?B-E----E--B------B-?B-B-B-M--BB--B--B-BBBB?--B---B-?-?---B---B
---|-B------B------?B------B---B|------BB--B-B----??EBBBBBBBMBB-?-B----------------B--BB??|-B-E------?B----B---------BB-------B--M----B?--B??BBMBB--------BB?-----B-BEB--B-B--?--B-------B--M-M------|--
-EB|B-|-----------BB------BBBBB-|-----BBB-B---BB??BMEBB-B--M---M?-BB?BB?---BM---B---B--?--B---B--B--?---------B-----------?BBBBBBB-------B-B----B-------B------B--B--?--B--------B-B?BB-------------B|BB
-B-|--|B--------------B?B-B--B--?B??BB---B-----B---?B--BBBB-B?B--BBBB----------B------B-----B?-MMBB------B--?B--M??B-MBB??BB?MBB-----------------B--------B-BB----B-------B|-B?--B--B-E---E----------|--
--B|B-|--------B-B-B-B-----B--B-B-M?---BB------------B----BB----M----?-------B---B--E--?--E-------------------------------------B----MB?-?B---------------B---M-----B------||?B-BBB-??BB-BB-BM--B---?|--
---|-B|-----B-B----?BB-B?BBB---------B-----B-MB------BB--------|----------?----?----B--?BB?-B--MB--B-BBBB-------B--?-----B-B---------------|BB-B?B?-B---BM------|-------|--M|------------|BB---BB----|-v
-?-|B-|--BB?-B-B-B-B--------B?---------BBB-----|-------------E-|B-BBB--MB-?--------?-----M--E?------------B--------?---?B--B--BB----------B|----|--E?----?-B----|-B--B--|?-B|MBBBBMB-M|-?|-------?B--|-f
---|--?BM--BB--------?--------B-----BBME--B----|---B---?B-B--B-|BB------------------BB----B-BM-BM--?-??M?--?------B-B----?--?-BB-|B---B----|----|--M---BB-----BBB?MBBB-BB---|---------|EB|B-B---B----B-f
---|-----BB--B--|-B--|---B---E--B-B----B?------|----------BBBB-|---BB---E--B-BB----------------E-??------------------BB?B?BBBBBMB|B--------|BB-B|B-?-B-?---M----------------|----B----|B-|M|-B---------f
B?-|--B---------|BB--|MBB----B------B-B----B-M-|-B------BMB--B-|-B----B-?BB?BBBBBBBB--B-BB-?---B?--------BBBMBB---BB---EBBBBBB---MB-B--E-E-|?BB?|BB?-B-----B?B----B--B-?BBB?|?--------|--|-|----B-----|f
-EM|B-M-B---?---|---B?-----?----------?--|-?---|------B----B---|-E---B-?--?--E?BM--BM-B?BB--BB-----?-------B?----------BB--------B-?B-M?-?-BM---|-----B----B?BBBB?M?------B?||------B-|-B|-|-B---BB?--|f
-BM?M?BB-B--M--?|?B-B----------------?---|---B?|?BB?BBM---B----|-BBBB-B---B--M?-----?-B-----BBB--------?B-----------B--BB---------------BBMBBM?M|B?BB-??B-------------M-----||-BB--BMB|--|-|--B--BBB--|f
mBB-?--B---B-BXB|BB--BE-BEBXB-?-?-B-E--BE|-----|BB?-X----T---?T|--X??-B----------EXBX-EXT-TX-----T?-MBB-B--B--E---?-X-X----------EBB-BE-B---B-T-|?X--E---T-----?-|-------B-E||BB-B-B--|B-|B|BBBBBBE--MXX
XXXTXTXXXXXXXXXXXXXXXXXXXXXXXXXXXXXTXXXXEXXXXXXXXTXXXXXXXXXXXXEXXXXXXXEXXXXXXXXXXXXEEXXXXXXXEXXXXXXXXXEXXXXXXXXXXEXEXXXXTXXXXXXXXXXXXXXXXXXXXXXXXXXXTXXXXXXEXXXXXXXXXXXXXXXXXXXEXXXXXTXXXXXXXXXXXXXXEXXX
