--------------------------------------------------------------------------------------------------------------------------------------------------------------------------------------------------------
-----------------------------------------------------------------------------------------------------------------------------------------------------------B-?------------T-----------------------------
--------------BBB-M-M---------------------------------------?-----B-----------------------------------------?-----------------------------------------?--?-------------T--|-----------------------------
----------------------------------------------------?---?-?------------------------------------------------------------------------------------------------------------|--|-----------------------------
---------------------------------------------------------------------B---B?---------------------------------------------------------------------------B--BB---B-BB-??--B-BBB----B-----------------------
-------------------B-?-B------------------------------------------------------------?--?---BBBM-----BBB?BM----------------------------------------------------------------------------------------------
-------------------------------------------BB?-BB?B-B-M-------------------------------------------------------------------------------------------------------------------------------------------------
---------------------------------------------------------------?-B----------------------------------------------BBB-----B---------B-B------------------------------------------------------------------v
---------------------B-B---------------------------B------B--------------------------------------------------BBBBB-BB-B-------------------------------------------------T------------------------------f
------------------------------------------------------------------------------------------------------------?----------------------------------------?--?---------------|------------------------------f
---O-------------------------------------------------B-?-M--B------------------------------------------------------------------BB?--------------------------------------|------------------------------f
---B------?--------B-?-?------------------------BB--B--B-B--B-------B----------------------------------------BB?BB-BB-?----------------------------------B----?---?-----|------------------------------f
---OO------------------------------------------T--------------------------------------------?BB-B--BBBB-----------------------------------------------------------------|--------T---------------------f
---OOO-O-O-O-----------------------------------|------------------------------------------------------------------------------------------------------------------------|--------|---------------------f
m-O-E-E--O---OO--------------------------------|-------------------------------------------------------------------------?M?--------------------------------------------|--------|---BB-BB-------------X
XXXXXXXXXXXXXXXXXXXXXXXXXXXXXXXXXXXXXXXXXXXXXXXXXXXXXXXXXXXXXXXXXXXXXXXXXXXXXXXXXXXXXXXXXXXXXXXXXXXXXXXXXXXXXXXXXXXXXXXXXXXXXXXXXXXXXXXXXXXXXXXXXXXXXXXXXXXXXXXXXXXXXXXXXXXXXXXXXXXXXXXXXXXXXXXXXXXXXXXX
