--------------------------------------------------------------------------------------------------------------------------------------------------------------------------------------------------------
--------------------------------------------------------------------------------------------------------------------------------------------------------------------------------------------------------
---------------------BBBBBBBBB?BBB---------------------------------------------B-------B---------------------------------------------------------------------------BBBBBBBBBBBB??B----------------------
--------------------------------------------------------------------------------------------------------------------------------------------------------------------------------------------------------
---------------M---B------------------------------------------------------------------------------------------------------------------------------------------------------------------------------------
-------------------------------------------B-------------------------------------------------B---BB-------?B-B-BB------------------------------------------MBB-------------TB-B-------------------------
-----------M?B----------------------------------BB?----?-B-B-------------------------------------------------------------------------------------------B-----B-------------|----------------------------
--------------------------------------------------------------------------------------------------------------------?---M------?-B--B-----?--------------------------------|---BB?M--M-----------------v
-----------------------------------------?------------------------------------?-------------------------------------------------------------------------------------B------|---------------------------f
-------------------------------------BB-------------------------------------B----------B--B?----B---B----------------------------------------------------------------------|---------------------------f
--------------?-B--------B------------------?-B-----------------------------------------------------------------?------------BB--------------------------------------------|---------------------------f
----B----------------------------------------------------------T------------------------------------------------------------?-------B-----------------------------B--------|--------B--B---B-----------f
-----------------------------------M---M-----------------------|-------------------B-------------------------------------------------------B--MB---T-----------------------|----B----------------------f
--------------------------------T-----------?-B?B-B----?-------|------------------------------B-B---B----------------------------------------------|-----------------------|---------------------------f
m--B-T-BBMBE-BB-B?--------------|------------------------------|-----------------------------------------------------------------------------------|-----------------------|---------------------------X
XXXXXXXXX?BBB?BB?MXXXXXXXXXXXBBBBXXXBBBXBXXBXBXXXXXXXXXXXXXXXXXXXXXXXXXXXXXXXXXXXXXBXXXXXXXXXXXXXXXXXXXXXXXXXXXXXXXXXXXXXXXXXXXXXXXXXXXXXXXXXXXXXBXXXMXXXXXXXXXXXXXXXXXXXXXXXXXXXXXXXXXXXXXXXXXXXXXXXXXX
