-----------------------------------B-B-----?-?-BBB------------------B---B?--------------------BB-----?--------------------------?--------------------------------E-------?------------------------------
-------------------------------------------------------------------------------------------------------------------------------B-MB--B--------------------B------?--------------------------------------
-----------------B--------?-----------------------|---------------------------E------------B------------------------------------B---BB------B----------------------------------?------------------------
-----------------B----B----------?----------------|---------------------------B---B--B-B---------------------------------------------------------?--B-------?--B----------------------------------------
?--EB-BB---------------------------MB---B?--------|---B----B--------B-B-----?B------------------------------------B-------B---------BM------B---------B--B---B--------------B--B---------------E-------?
--MB----------B---BB--B----------B---?-BB-B----|--|-------------------------BB---B------B-----B----?--------?-B-B--------------------------BB-------------M|---BBB------EB-----?-----BBB--B--?BM-BB?----
-----M?B?--BB?-BB-B----BB--?------?----------BB|B-B---------------------B-B----------?--------B----?--------------------------------E-E--------------------|--------BBBB?-B?---------------B------------
-----------------|-----------------------------|-----------|--------------------------B--B---B----B---------------------------?----BB-B--------------------|------B--------B?-B------------------------v
--?---------|----|-----------------------------|----------B?--B--B---BBBBB?BB?----------------------------------------BBBB?BBB?--------------------------B-?-------------------------------------------f
------------|----|--------B-------M??---BB?B-?-B------------------------B--?B?|----------------------------------M----------E---------------------------??BBBBBBBBB------------B-----------------------f
------------|?---|E------M-M-----B-----------B-B-B--B-------------------------|---------B---------B----------B--------------B---------?--------BB-B--M-----------?-------------------------------------f
--|---------|-B--|B----B-B---B-------BBB--------------------------------------|---------------------------------------B---B-------------------B----?----------------------B?B--?-----------------------f
--|----?----|----|----------------E------------?--M-------------|-----B----B--|---------------?----B-------------?-----M---------------------------------M--------------B-----B--------B-----??M--B----f
--|--------B|B---|B----?BB-?---B-|E-B-?-------------------------|-------------|-----------E-------------B---------------?-----T------------?---------------B-----B---------B------------------X--------f
m-|---------|BTB?|B-X----XBE-----|B----E---X----X---------------|---X-B--TBBB-|------BB---MTBB---E--E----|--E----E----TX------X---T--T----M---XB---EXB----B--E-E------BB--BB--?----X-T---EBBBBXEBBB?BBBX
XXXXXTXXXXXXXXXXXXXEXXEXXXXXXXXXXXETXTXXXXXXXXXX-XXX-XEXXTXXXXXXXXXXXXXXXTXXXTXXXXXXXXTXXXXXXTXXXXT-XXXXXXXXXXEXXTXEXXXXXEXXXXXXXXXXXXXXXXXXXXXXXXXXXXXXXXXXXTXXXXX-XXXXXXXXXEXXXXXXXXXXXXXXXXXXXXXXEE-X
