-----------------o----------------------------o-o--o------o-----------------------E------------------E----B---------B-B-BB----o---------Bo--------------E--------o-------------B--------------E---------
-----------------o--BBM----o-B------------------?--?------B--------B--------------o--o---------------E-----------------o------E--o----------------------------------------E-----------------------------
-----------------o------------------o-----------------------------------------------E-Eo-o-----------M--E------------B-B------M-----o--B----E----------o?-oEE--o-o--------?---------------o---B---------
--------M----o---BB-----B--B----------?B-----BB--B---B-----E----------o-------B---B--o??-o-o---------B--B----------B----o-----B-Bo--o-B--B---------o---B--oB-----B-----------------o------------o-------
--------o--B-B----------------------o----------------o---------o--------------------BBoB-B-B--------BBBB?MBBBBBM?----------------BM-B-------BB-----o------B-?--E-------------------------------o--------
---?----o-----------------------M--BB----------------E-------o-M-?B---oM-----------o-----------------o-----------------------------------B---------------------B---------------E-B-B------B-------------
--------BM-------------------M---B-------o-----------?-----B-B----B---Bo-BB--------B--B--------------o------------------?BB?B-BB-------------oB--B-B----B---------B------------?--------oo-----BB-------
--------oo----Bo-----------------------------B---------------o-------o-------------------------------o--oo--B-------o---------oo--------B------o--E-------------o-----------------------oB-----B---?---v
-----o--B?----M?--------------------M----o-----------------------------------------------------------B--?------------B-B---------------E-E---o-?-----B------B---B--?---------------T----MB---o-?-------f
---B----M--------o--------B----B---------B---------------------------M-B-----------B---------------BB----B-B--------B---------o--------------B------------o---------------o-------B|-?----M-oE---------f
----------------------------o?------------------------E------B------B----------o-------------o--------------------------------B?-------T-------?--E--------------o-----o-?M----B---|-o------T-B--------f
-----B-B---------B-------B-----B----o--------------o--B-----B-BBBB-------------o-------------E----o------------o------o---------------o|-B----o---?Eo---o-------o-------T---EE-----|----o---|B----B-B-of
-------o--?----------o-oo---Bo---o---o?-oo-?--o--oo-oo--o-E--oo----Eo-o?oo-----B-E-o-ooo-E--o--E---o-o-E--oo-o--E--oo-T--oE----o-oo-o-?|oE-o-Eo----oT-oE?-?o-o-------E--|-TEoM-----|-o--EE--|--o--Eo--Ef
--------o------o--------o----o-oB---Bo-oo--o---oo--T---E---E-o-o----B-ooo----o---ooo---------?-Eo-E-o--oo-ET-BoBo-o---|----oo-Eo--oE-Eo|-o-E--o-E---|?--o---M--ooB---ooB|-|EBo-ooEB|-?-o-E-o|--E-EBoMo?f
m-o---o-o---B-o-?-----BBo?B-?-o--X--Xooo-o-o-oXoo-oBo----o--ooo---TE-E-Eoo------T----o--EoX-T---BTB---o-ooT|--E--E--Xo|--oo----ooo-o-o-XEoo--oT--o-T|-X---T--oT-XoT-oo--|E|To-o-oo-|----T--T|Eo----o-ETX
XXXXXXXXXXXXXXXXXXXXXXXXXXXXXXXXXXXXXXXXXXXXXXXXXXXXXXXXXXXXXXXXXXXXXXXXXBXXXXXXXXXXXXXXXXXXXXXXXXXXXXXXXXXXXXXXXXXXXXXXXXXXXXXXXXXXXXXXXXXXXXXXXXXXXXXXXXXXXXXXXXXXXXXXXXXXXXXXXXXXXXXXXXXXXXXXXXXXXXXX
