--------------------------------------------------------------------------------------------------------------------------------------------------------------------------------------------------------
------------------------------------------------------------------------------------B-B-----------------------------------------------------------------------------------------------------------------
--------------------------------------------------------------------------------------------------------------------------------------------------------------------------------------------------------
--T------------------------------------B?B?B-------------------------------------------------------------------------------------------B?BBBBB----------------------------------------------------------
--|-----------------------------------------------------------------------------------------------------------------------------------------------------------------------------------------------------
--|-----------------------------------------------------------------------------------------------------------------------------------------------------------------------------------------------------
--|---------------------------------------------------------------------------------------------------------------B-------------------------------------------------------------------------------------
--|-------------------------------------------------?---M----------------------------------------------------------------------B--?----B--BB-----------------------------------------------------------v
--|---------------------------------------------------------------------------------------------------------------------B--B---------------------------------------------------------------------------f
--|-----------------------------------------------------------------------------------------------------------------------------------------------------------------------------------------B?B--------f
--|------------------------------B-?----B-B--B------------------------------------------------------------B?BMBB?--------------------------------------------------------------------------------------f
--|------------------------------------------------------------------------------B-B----B-----------------------------------------------------------------B----?---------------------------------------f
--|------O----------------------------------------------------------------------------------------------------------------B----------------------------------------------------------------------------f
-O|----------------------------------------------------------------------------------------------------------------------------------------------------------------------------------------------------f
m-|----------------------------------------------------------------------------------------------------------------------------------------------------------------------------------------------------X
XXXXXXXXXXXXXXXXXXXXXXXXXXXXXXXXXXXXXXXXXXXXXXXXXXXXXXXXXXXXXXXXXXXXXXXXXXXXXXXXXXXXXXXXXXXXXXXXXXXXXXXXXXXXXXXXXXXXXXXXXXXXXXXXXXXXXXXXXXXXXXXXXXXXXXXXXXXXXXXXXXXXXXXXXXXXXXXXXXBBXBXXXXXXXXXXXXXXXXXX
