--------------------------------------------O------------------------B-BB----B?BB--O---O----O------------------E-------------------------------------------MB---O------B-----------------------------O--
--------?--------------B----------BB-------O----OO--------------?-----------------------------B---------E---------O---------O----?---------------------M-----B--?-----O-O---B------------------------B--
-------O--B-----B-----------------------------O---------------------------------------------------E-----------EBB-M---?----------------------O------------------------?--O--O---------------------------
-------O-------------------------B----B-----B-M-B-----------------O---------------O?---B----?---O-?---O-BB-------------O----B----------------B-O---O---------E----------BB------O-----------------------
--------------------------------------O--B-B---?-BB-------------BB?--------E---------O----------B--BO-E-----------E----------------------------?---O---E-----O-----------BO-B---------------------------
-------B---------?---O----B-M---------O-OB-?---?-?---O-----OB------------------------O-------B--------B--M----?---B----B-------O-----------?----O--B---B-----MB--OMO-BB-O-B-BOBBB-------B---BB----------
-----B--OB-----B-B---B----------------?BB------------E--O---------?--------?B-----B--?---BB-O---EO------O--------E---?---------OE-----------------E--------O-------O---------E---------O---O------------
-------B--B-------------?--B------B----------------------B?---E----?BB-----EO---O---O------------B-OM------------O--------------O---------------B-B-?BBB-O-------B-B-----------------------B-----------v
-----------------------------------------------------B---B-B-BB-------B--M-O--O-----E---B------BBB-BB---B?BB-----O--------OT-B-BB-----------?------------O----OE---?----B--B-B--------EO--E------------f
--------B--B--------------------O------------------O-B--B------------------?BOO-?--O-------?B---B--?--M-?--------?---------|---T---------------B-----------BB--O-----------------O----?B--B------T--O--f
-?-O----?B?MB----------O-----------------------------------------------------?B-----B-------E------------------------------|---|-----------E---------B---B----?------------------B--B------------|-----f
------------------------------MBB-------------------------------------O--B---------B-----------------------------M-----B--B|---|--E----O-O----B-----E--B-----B-?B-------------------EB--B-?------|O--O-f
--O?O-O--O----------O-O?---BOO---O--O-O---OO-OOOOO-?--OOTOE--O--OO-ET-?-O---E-OE-O-O--------E-O-E-O----EE-O-O-O--OO--O---O-|E-O|-O-E-E-----EE-O-O----OO-?--OMO---O-O--OOO------EOBOEB-OOOO---O-O-|--??Of
---OO--------O--OO--O--B--B-?-OOO----------O--O-------E-|------O-O--|---E---O-O--O-OEOO-BOO-T---------O-OOOO------O-OO-BO-B|-OO|-O-O-O-BO-O?O-O--O---O--E-O-----O--O?-----O---B--EO-E--------O---|--E-Of
m------B----OO--B-?O-------XOO-O---O--O-OO------OOO---O-|TOEET-X---T|T--O--O-O---EO--T--O-O-|-T-T-OOEX---OXOO-E-EXOBO-OB--T|O-O|O-TO-OE-OTOX-OT-OO--TTO-O---T-OOOO--XETO------O-OO-TXO----TO--OT-|OE?ETX
XXXXXXXXXXXXXXXXXXXXXXXXXXXXXXXXXXXXXXXXXXXXXXXXXXXXXXXXXX??BBB?BB?BBBBXXXXXXXXXXXXXXXXXXXXXXXXXXXX?XXXXXXXXXXXXXXXXXXXXXXXXXXXXXXXXXXXXXXXXXXXXXXXXXXXXXXXXXXXXXXXXXXXXXXXXXXXXXXXXXXXXXXXXXXXXXXXXXXXX
