----------?????????--------------------B------------------------------------?------------------------------------?------?-?-----------------------------?----B------------------------------------------
-BB---B---------MM--M----M-----M--M-------M---------------------BBB--------------------------------------------------------------B--MMMMB-MBM-XM--M-----------------------------------------------------
-----B---------------------------------------------------------------BBBBBBBBBBBBBBB|-------B--BB------------X---------?----?---------------------?-----------------------------------------------------
--B--------------------MM-M-M--M-M-M----------------------------------------B--B----------X------?-----------X-------------|-------------------------?--M-B?----B-BE---------------------------M--------
----------------------------------------------------------?--M-MMM-M--------------------X-------------------------------?--B???----B----------X--------MM--MM---M--MMM---M------------------------------
-|--B---------MB-MM--M-M---M------|-?-?-----------BBB-----B?---------M--M---------------X--------------------X----------------------BB-XB-B---B|-B---M------M--B---M------------?--?--??---MM-----------
------------------------BB-B--B-----?-------------------?---------B---------------M-|-B-X------------?-?--------|---------------B------X-------B-BBBB---B-------?BB-----B-B------?---?-?------MX----MMM-
-|------------------------|--------------------X----------------------X-----------------X---------------B------------------------------X---------X------------------------------?-?----------X---------v
-----------------------?--??-------------------X---------------X---|--X--B--------------X-----T-----------------|---------|-BB---------X-------------B---------------------------|-------------X-------f
-|-------------------T-----------B------X---?--X---------BBBB?B----?---------X----------X-----------BB---|?|---------BX---|X----------MX---------------------B--X-|--------X-------------------X-------f
----------------M-|------------MXBMM--M-XM-----X------X---------------------------------X----------------|------------X----------------X---------X--------------XM|---M----X---------BB-?------X----M--f
-|----------------------B----B--X--------------X---------------X------------|X------|---X--------|-|-B-----MM-M------T-----X-------X--MX--------------------------|---------B--B---------------T-------f
-------X------?-M-----?-----------------X---BBBX-----EM------------X--X-----X----|MMMM?MXMBBMMMM---------|-------M---------XX---------XX----------?-------------X-X---M|---------?-X------B?---X-----X--
------------------X----------?|-X-X------------X----M-E---???????????-X--|-------|------X-----|----|---------X-----M------|------------X---------T---T--BBBBBBB---|----X--------?---BB--T--B-B-X-E-----f
m------X-X----E-T----T-----E--|------X-----T---X------X|-X--X------X-X---X--X-----------X-----X--------------X---------E--|M-X--------XX-X--X----X-XX-----E----|X-X----|---B-B-BB--XT---X-M----XM----X?X
XXXXXX-XXXXXXXXXXXXXXXXXXXXXXXXXXXXXXXXXXXXXXXXXXXXXXXXXXXXXXXXXXXXXXXXXXX-XXXXXXXXXXXXXXXXXXXXXXXXXXXXXXXXXXXXXXXXXXXXXXXXX-XXXXXXXXXXXXXXXXXXXXXXXXXXXXXXXXXXXXXXXXXXXXXXXXXXXXXXXXXXXXXXXXXXXXXXXXXXX
