-----------------------------------------------------------------------------o--------o---------------------------o-----o--o-------------E-----------------------------B-------------B---?B--M------B---
----------------o--------------B-----?------o--------------------------------BBBB-----B--?----------------------------o----o---------B-------------------------------------------------E------o---------
--------------o-Bo--B----------------------------------------------------o-------------------------------------------BB-B--?B----------B-B-B-o-------E----------------------------------------B----B-B--
--------------o-------o--------------------------------o-o--------------------o-------------------?---B------o----B-----------------BB-?-B---------------------------------------------o------B---------
-----B?--o---??---?-o------------o---?B-----B------------o---------------------BBBBB---------------------------------?B-B----------BBBB?M?BB-------------o-----------------------B-----??-----o---------
------o?-B--M---B?--B-?--------o-------------------o--B----------------?-?---BB--------------------------B---B----------------------------o--B-BB--o-B??-B---B-------------o----E-------------E---------
---------------------------------B---M------??-?B------BBB------E-----------------------------B---B-------------------------------B?--B-B-----?-----------------------E----oo-oo----oE--------B---------
-------MBB---------------------o------------------------------------E-----------------------------o------B-----------------E-----MB-------?-?---?---------------------o--B--B--B----BB-----------------v
--B-BBB-B----------------------B-------------------?------------------------------------------B---B--BM-----------------------o-----o------------BBM-------------o---------B--?-B----------------------f
-------o---------------------B-B---o--------M-------------------B---B----?---?--B-----o---------------E---------------o-------------o---o------o-------o--------o-----T---o---------------------------Bf
-------B---------------------BB?-B-------------------------------------B--------------------oTB---B-----------------B--o---B--B-----B----------------??B-B-----o-B----|---E-----------?----BB-------T--f
-------------------------------------B------?-----------------T-----------o-----------E------|-------o-------o---------------------------------B--------B----oBT------|---B-------------o-----------|--f
---oo----ooo-----o------oo---------?-----o--o--oo--MEo--------|E-E-?-o----?E-o---oo--oTo?--o-|o---?-o-oB--o--oEo----o-?-------?E-oM?--BoBE-?-o--ooo-E-oT--ooo--|BBE---|o---ooo---E---------oo-E-?-oo|-Ef
---?--Boo---oBB---o------o--o--------o----o-o---------oooo--o-|o-o-o----o--oo---oo----|--oBBB|-oo-oETo--E-oEEMB-o----?o?o--oooE---oo-o-o--o------E---Eo|---oo--|-o----|---oE----o-----------oE--oo--|--f
m-o----o-----o-o-----ooX--o-oo-------X---o--------o--o----o-T-|--o?o---o-o-oo-oT---o-o|oE-XE-|-o-Eo-|T--------o-o----TXo-----E-o---X--oE--TEo-EE-ooo-o-|E-T--T-|oooT--|o-oX-oo-----oE-ToT--------oEo|--X
XXXXXXXXXXXXXXXXXXXXXXXXXXXXXXXXXXXXXXXXXXXXXXXXXXXXXXXXXXXXXXXXXXXXXXXXXXXXXXXXXXXXXXXXXXX-XXXXXXXXXXXXXXXXXXXXXXBXXXXXXXXXXXXXXXXXXXXXXXXXXXXXXXXXXXXXXXXXXXXXXXXXXXXXXXXXXXXXXXBXXXXXXXXXXXXXXXXXXXXX
