----------------------------------M---------------------------------------------------------X----------M------------------------------------------------------------------------------------------------
--------------------------------------------------------------------------------------------------------------------------------------------------------------------------------------------------------
------------------------------------------------------------------------------o-------------------------------------------------------------------------------------------------------------------------
--------------------------------BBB---------------------------------------XXXXXXX---------------------?-------------------------------??????-------------X----------------------------------------------
--------------------------------------------o----------------------------X---------------o-------------------o----------?-------------------------------------------------------------------------o-----
------------------------------------------------------------B--------------------------------B-X------------------------------------------------------------------------------X-------------------------
-------------------------------------o--------------------------------------------------------XX----------------------------------------------------T---------------------B-----------------------------
-----------------------------X-----?-----------------X----------------???????----------------XXX-----------------T-------B------------------X-------|--------------------------------------------------v
-----------T----------------------------------------X---------------------------------------XXXX---------M-------|----------------------------------|--------------------------------------------------f
-----------|-------------------o-----?-------M-----XX-----------T--------------------------XXXXX-----------------|------------?---------------------|---------------------------B----------------------f
----?------|-----------X-------??????-------------XXX----o-----M|--------?----------------XXXXXX-----------------|---B----?-------------X----B------|--------------------------------------------------f
-----------|-------------------------------------XXXX-----XXXXXX|X--------------?--T-----XXXXXXX-----------?T----|---------------------XX-----------|-----X-------------------T------------------------f
----------?|------------------------------------XXXXX-----------|o------T----------|----XXXXXTXX------------|----|M-------------------XXX-----------|-----XX------------------|------------------------f
-----------|-----------------------------------XXXXXX-----------|-------|----------|---XXXXXX|XX------------|----|-------------------XXXX-----------|-----XXX-----------------|------------------------f
m----------|--------E-----------------E-------XXXXXXX---E-------|---B---|----------|E-XXXXXXX|XX-E----------|----|-------E----------XXXXX-----------|-----XXXX--------BBBBE---|-------------------E----X
XXXXXXXXXXX|XXXXXXXXXXXX-----XXX---XXXXXXXXXXXXXXXXXXXXXMXXXXXXX|XXXX---|--BBBBBBBX|XXXXXXXXX|XX-------XXXXX|XX--|----XX-----XXX---XXXXXXXXX----XXXX|XXXXXXXXXXXXXXXXXXXXX---X|XXXXXXXXXXXXXXXXXXX--?--X
